...........
#####......
#####@#####
####..##...
.........##
#######..##
########...
#######...#
.....#....#
###....####
#####.#####