#####.#####
#####.#####
.....@.....
#####.#####
#####.#####
#####.#####
#####..####
######.####
######.####
######.####
######.####