#####.#####
...........
#####@#####
...........
#####.#####
...........
#####.#####
...........
#####.#####
...........
#####.#####